id;actual;declared;union;intersection;undeclared;unused
aabcgdmkeabbnleenpncegpcngjpnjkc.crx;4;5;5;4;0;1
aadgmnobpdmgmigaicncghmmoeflnamj.crx;0;2;2;0;0;2
aaebjepcfidgkojljbgoilgkgklehldj.crx;3;3;3;3;0;0
aailiojlhjbichheofhdpcongebcgcgm.crx;1;12;12;1;0;11
aakchaleigkohafkfjfjbblobjifikek.crx;2;6;6;2;0;4
aapbdbdomjkkjkaonfhkkikfgjllcleb.crx;2;3;3;2;0;1
abjcfabbhafbcdfjoecdgepllmpfceif.crx;1;2;2;1;0;1
abpbcfijgmlbecbplnfknakoemncanbo.crx;0;1;1;0;0;1
acgimceffoceigocablmjdpebeodphgc.crx;0;0;0;0;0;0
adepkmleadimefolboaaedghfnnbfpnp.crx;2;6;6;2;0;4
adicaaffkmhgnfheifkjhopmambgfihl.crx;0;2;2;0;0;2
adllellfifhkdgekblogkphpalcbfooh.crx;0;2;2;0;0;2
admmjipmmciaobhojoghlmleefbicajg.crx;3;11;12;2;1;9
adokjfanaflbkibffcbhihgihpgijcei.crx;6;9;9;6;0;3
aeblfdkhhhdcdjpifhhbdiojplfjncoa.crx;0;13;13;0;0;13
aeeajafchghccbnppaimjhhfpejabole.crx;1;5;5;1;0;4
aefkmifgmaafnojlojpnekbpbmjiiogg.crx;2;4;4;2;0;2
aejoelaoggembcahagimdiliamlcdmfm.crx;2;9;9;2;0;7
agibagflppafhfonkefpklndlohkclcb.crx;0;3;3;0;0;3
agimnfedoejnbcaboobehgdeppecefap.crx;0;3;3;0;0;3
ahmpjcflkgiildlgicmcieglgoilbfdp.crx;0;11;11;0;0;11
aicmkgpgakddgnaphhhpliifpcfhicfo.crx;3;4;4;3;0;1
aiffpfmnpgfjinmgehcanknmnmaheamg.crx;0;0;0;0;0;0
aiimdkdngfcipjohbjenkahhlhccpdbc.crx;2;9;9;2;0;7
aikbehojjdffmangolfbohjdigfdnepa.crx;3;4;4;3;0;1
aioencjhbaolepcoappllicjebblphoc.crx;0;2;2;0;0;2
ajmecfihhnibjmmihpecefjjckgbmedh.crx;3;6;6;3;0;3
ajneioealmmeomlfegpbamcjhiiedcag.crx;1;4;5;0;1;4
ajojghojfapedgfkjmhchgblmjfanggo.crx;1;2;2;1;0;1
ajopnjidmegmdimjlfnijceegpefgped.crx;0;1;1;0;0;1
akaelkiagnbfcccfnmbimdbplecgbikh.crx;0;0;0;0;0;0
akdgnmcogleenhbclghghlkkdndkjdjc.crx;3;5;5;3;0;2
akgpcdalpfphjmfifkmfbpdmgdmeeaeo.crx;2;1;3;0;2;1
akimgimeeoiognljlfchpbkpfbmeapkh.crx;3;4;4;3;0;1
aleakchihdccplidncghkekgioiakgal.crx;1;1;1;1;0;0
aleggpabliehgbeagmfhnodcijcmbonb.crx;3;5;5;3;0;2
alplpnakfeabeiebipdmaenpmbgknjce.crx;3;11;11;3;0;8
amddgdnlkmohapieeekfknakgdnpbleb.crx;0;1;1;0;0;1
amigcgbheognjmfkaieeeadojiibgbdp.crx;1;5;5;1;0;4
amjcoehkcacocffpmhnefgoeanepjfkf.crx;3;8;8;3;0;5
amjmjholfoknokffkiolahocokcaecnc.crx;3;6;6;3;0;3
ancbofgphhmhcchnaognahmjfajaecmo.crx;1;5;5;1;0;4
andokbmfkopokkinpoodkhciomilhece.crx;0;11;11;0;0;11
aoanickgmocpddnppajakfcafbkncdab.crx;2;5;5;2;0;3
aohddidmgooofkgohkbkaohadkolgejj.crx;0;2;2;0;0;2
aoiidodopnnhiflaflbfeblnojefhigh.crx;0;5;5;0;0;5
aomidfkchockcldhbkggjokdkkebmdll.crx;0;4;4;0;0;4
aomjjhallfgjeglblehebfpbcfeobpgk.crx;3;6;6;3;0;3
aopfgjfeiimeioiajeknfidlljpoebgc.crx;0;8;8;0;0;8
apcedakaoficjlofohhcmkkljehnmebp.crx;1;1;1;1;0;0
apfkjncelobloojfkbmendgmfgnfmbla.crx;1;8;8;1;0;7
apghicjnekejhfancbkahkhdckhdagna.crx;1;0;1;0;1;0
baggnalhgbpeanbhedjlbndhjgmimmhl.crx;2;3;3;2;0;1
bahkljhhdeciiaodlkppoonappfnheoi.crx;7;11;13;5;2;6
baohinapilmkigilbbbcccncoljkdpnd.crx;0;4;4;0;0;4
bbcnbpafconjjigibnhbfmmgdbbkcjfi.crx;0;2;2;0;0;2
bbecnnkcccinkpblhmamngbiengkfbbf.crx;0;10;10;0;0;10
bbmegnmpleoagolcnjnejdacakedpcgd.crx;3;11;11;3;0;8
bcjindcccaagfpapjjmafapmmgkkhgoa.crx;0;2;2;0;0;2
bckebbpihkkoonigakijdplcakdgfdfg.crx;2;9;9;2;0;7
bclmkgofhdgekpoamoialodjdloiilod.crx;2;5;5;2;0;3
bdakmnplckeopfghnlpocafcepegjeap.crx;3;7;7;3;0;4
bdlhpbalhdjobabgbacbgclpjjelainj.crx;0;2;2;0;0;2
bdlknlbjcalhjjoolopamghjaehhgmmg.crx;2;5;5;2;0;3
bekpmjjfikbojlfahehhgnaebgjgkmmh.crx;0;0;0;0;0;0
bfbameneiokkgbdmiekhjnmfkcnldhhm.crx;4;8;8;4;0;4
bfbmjmiodbnnpllbbbfblcplfjjepjdn.crx;2;4;4;2;0;2
bfegaehidkkcfaikpaijcdahnpikhobf.crx;0;0;0;0;0;0
bfmdmbkhckncibmbjgmfbeehnnkknnad.crx;0;2;2;0;0;2
bfogiafebfohielmmehodmfbbebbbpei.crx;1;5;5;1;0;4
bgdpkilkheacbboffppjgceiplijhfpd.crx;0;1;1;0;0;1
bgnkhhnnamicmpeenaelnjfhikgbkllg.crx;0;8;8;0;0;8
bhghoamapcdpbohphigoooaddinpkbai.crx;2;3;3;2;0;1
bhlhnicpbhignbdhedgjhgdocnmhomnp.crx;0;2;2;0;0;2
bhloflhklmhfpedakmangadcdofhnnoh.crx;0;0;0;0;0;0
bhmmomiinigofkjcapegjjndpbikblnp.crx;0;6;6;0;0;6
bifidglkmlbfohchohkkpdkjokajibgg.crx;3;7;7;3;0;4
bigefpfhnfcobdlfbedofhhaibnlghod.crx;2;4;5;1;1;3
bihmplhobchoageeokmgbdihknkjbknd.crx;0;12;12;0;0;12
bijihlabcfdnabacffofojgmehjdielb.crx;2;2;2;2;0;0
biokbpahnhnolgnfoblfflgopeepaoik.crx;5;12;12;5;0;7
bjgfdlplhmndoonmofmflcbiohgbkifn.crx;2;4;4;2;0;2
bjjhfmdnoonajbncgfjndbajofekbjki.crx;5;12;13;4;1;8
bkbdaodnaecdijpajecpncpdomgcoakc.crx;0;1;1;0;0;1
bkbeeeffjjeopflfhgeknacdieedcoml.crx;2;3;3;2;0;1
bkdgflcldnnnapblkhphbgpggdiikppg.crx;3;11;11;3;0;8
bkfmjmjngglphchhiemnghidpnddofmo.crx;1;2;2;1;0;1
bkhaagjahfmjljalopjnoealnfndnagc.crx;1;1;1;1;0;0
bkmjlcbkppjpiianckgofgolfojkdeep.crx;4;12;13;3;1;9
bkpenclhmiealbebdopglffmfdiilejc.crx;0;2;2;0;0;2
bkpgjmojkmhihgfnbnfoipcdpopkhipo.crx;5;12;13;4;1;8
bldgenmjegcnjebiongilahhcjldgmlm.crx;1;1;1;1;0;0
blipmdconlkpinefehnmjammfjpmpbjk.crx;0;3;3;0;0;3
blkboeaihdlecgdjjgkcabbacndbjibc.crx;3;5;5;3;0;2
blndkmebkmenignoajhoemebccmmfjib.crx;1;5;5;1;0;4
bmimdmkleccdoghpgdhaahkelfhjfhgm.crx;1;7;7;1;0;6
bmmbajpcfedaechekcachdldkdfaalbf.crx;5;12;13;4;1;8
bmnlcjabgnpnenekpadlanbbkooimhnj.crx;3;5;5;3;0;2
bnjjngeaknajbdcgpfkgnonkmififhfo.crx;2;3;3;2;0;1
bnmgbcehmiinmmlmepibeeflglhbhlea.crx;5;14;14;5;0;9
bnomihfieiccainjcjblhegjgglakjdd.crx;1;1;1;1;0;0
bodncoafpihbhpfljcaofnebjkaiaiga.crx;1;2;2;1;0;1
boelillbfolbijkhknbmfdhehcppmcia.crx;0;0;0;0;0;0
boemmnepglcoinjcdlfcpcbmhiecichi.crx;1;4;4;1;0;3
bofbpdmkbmlancfihdncikcigpokmdda.crx;3;6;6;3;0;3
bohahkiiknkelflnjjlipnaeapefmjbh.crx;0;1;1;0;0;1
bojgejgifofondahckoaahkilneffhmf.crx;1;5;5;1;0;4
bpconcjcammlapcogcnnelfmaeghhagj.crx;5;14;14;5;0;9
bpgpffljkgjmijjdmjbdppndoojdgboe.crx;0;0;0;0;0;0
bpojelgakakmcfmjfilgdlmhefphglae.crx;3;6;6;3;0;3
bppbpeijolfcampacpljolaegibfhjph.crx;0;0;0;0;0;0
cacfnookefkldifaigjdedpophfjkjeh.crx;0;1;1;0;0;1
caclkomlalccbpcdllchkeecicepbmbm.crx;1;1;1;1;0;0
caljgklbbfbcjjanaijlacgncafpegll.crx;1;10;10;1;0;9
cammakhaipbljopbkbbffhachjekcfki.crx;0;3;3;0;0;3
camnampocfohlcgbajligmemmabnljcm.crx;4;6;6;4;0;2
canbadmphamemnmdfngmcabnjmjgaiki.crx;4;4;5;3;1;1
cbhfdchmklhpcngcgjmpdbjakdggkkjp.crx;3;3;3;3;0;0
cchjabbpienhimbelhmapejpadmeoajm.crx;0;4;4;0;0;4
ccjleegmemocfpghkhpjmiccjcacackp.crx;3;9;9;3;0;6
cdbpjflelnapbhcfafncmhkhihdibegl.crx;5;12;13;4;1;8
cdchjnfonmcmbclbcbcicknddglglnha.crx;0;5;5;0;0;5
cdenlcnfdjepagejpfajlkicggieknab.crx;0;0;0;0;0;0
cdochbecpfdpjobpgnacnbepkgcfhoek.crx;0;1;1;0;0;1
cdoinklelehcpndgmcddkkdhibpoglnk.crx;0;7;7;0;0;7
cedihplmdadkgmhdlblolekfbpghnppa.crx;1;2;2;1;0;1
ceifkijcgaeoplocgjkgbekfhledgink.crx;0;0;0;0;0;0
ceimgagkkofjoalgojpkdcmhmbljbbaa.crx;2;6;6;2;0;4
ceopoaldcnmhechacafgagdkklcogkgd.crx;5;12;13;4;1;8
cepmakjlanepojocakadfpohnhhalfol.crx;0;2;2;0;0;2
cfhdojbkjhnklbpkdaibdccddilifddb.crx;0;9;9;0;0;9
cfidkbgamfhdgmedldkagjopnbobdmdn.crx;1;7;7;1;0;6
cfnpidifppmenkapgihekkeednfoenal.crx;0;4;4;0;0;4
cgakmbkklpmijhckpolanjijghgfpeoa.crx;0;2;2;0;0;2
cgbhdenfmgbagncdmgbholejjpmmiank.crx;2;8;8;2;0;6
cgdjpilhipecahhcilnafpblkieebhea.crx;1;4;4;1;0;3
cgjnhhjpfcdhbhlcmmjppicjmgfkppok.crx;2;4;5;1;1;3
cgmnfnmlficgeijcalkgnnkigkefkbhd.crx;1;3;3;1;0;2
chgpmaaockmdehmidghebcjafhihlgha.crx;1;2;3;0;1;2
chhjbpecpncaggjpdakmflnfcopglcmi.crx;2;6;7;1;1;5
chklaanhfefbnpoihckbnefhakgolnmc.crx;1;3;3;1;0;2
chlffgpmiacpedhhbkiomidkjlcfhogd.crx;4;6;6;4;0;2
chphlpgkkbolifaimnlloiipkdnihall.crx;0;5;5;0;0;5
cidlcjdalomndpeagkjpnefhljffbnlo.crx;2;3;3;2;0;1
cimpffimgeipdhnhjohpbehjkcdpjolg.crx;0;5;5;0;0;5
cjbjepchlgclmpinlbbeinajphohgfod.crx;0;6;6;0;0;6
cjpalhdlnbpafiamejdnhcphjbkeiagm.crx;5;9;9;5;0;4
ckcbfnpodigdcbjjmhmolhkhlfbepnca.crx;0;0;0;0;0;0
ckiahbcmlmkpfiijecbpflfahoimklke.crx;5;9;9;5;0;4
ckjefchnfjhjfedoccjbhjpbncimppeg.crx;0;1;1;0;0;1
cknebhggccemgcnbidipinkifmmegdel.crx;2;5;5;2;0;3
clgckgfbhciacomhlchmgdnplmdiadbj.crx;3;9;9;3;0;6
clgenfnodoocmhnlnpknojdbjjnmecff.crx;0;0;0;0;0;0
clikkblliffbbkffahjehcdeknmedelg.crx;1;1;1;1;0;0
clloobkgbdighillbfomkhjhgeempchd.crx;0;1;1;0;0;1
cmeakgjggjdlcpncigglobpjbkabhmjl.crx;4;8;8;4;0;4
cmendinpapjjojakimjlmkkkcmnojefg.crx;0;5;5;0;0;5
cmhicdplfejcchpmimlnohfadpimciaa.crx;0;1;1;0;0;1
cmkdbmfndkfgebldhnkbfhlneefdaaip.crx;0;5;5;0;0;5
cmllgdnjnkbapbchnebiedipojhmnjej.crx;6;9;9;6;0;3
cnaibnehbbinoohhjafknihmlopdhhip.crx;0;3;3;0;0;3
cnbhdbbdefaakpmjbpibaadnhafincnd.crx;1;7;7;1;0;6
cnpniohnfphhjihaiiggeabnkjhpaldj.crx;1;2;2;1;0;1
coahpcpgfnnaddeelpphpifmgfobflog.crx;2;6;6;2;0;4
cocfojppfigjeefejbpfmedgjbpchcng.crx;3;10;10;3;0;7
cohgcponedmbhgbbdinajeoapmoaifdj.crx;0;0;0;0;0;0
cpbghpalffgmgocmnigfhalghmaemffo.crx;1;5;5;1;0;4
cplklnmnlbnpmjogncfgfijoopmnlemp.crx;10;15;15;10;0;5
cppjkneekbjaeellbfkmgnhonkkjfpdn.crx;3;4;5;2;1;2
dafalpmmoljglecaoelijmbkhpdoobmm.crx;3;4;4;3;0;1
dagcmkpagjlhakfdhnbomgmjdpkdklff.crx;0;3;3;0;0;3
dajedkncpodkggklbegccjpmnglmnflm.crx;2;4;4;2;0;2
daocgoilgdmkpilllpkjbaankampnbmj.crx;1;6;6;1;0;5
daoidaoebhfcgccdpgjjcbdginkofmfe.crx;2;7;7;2;0;5
dapjbgnjinbpoindlpdmhochffioedbn.crx;1;2;2;1;0;1
dapoijobnfbbkflnhnjlifonpegdcaip.crx;2;5;5;2;0;3
dbaonaocldpohelilahfhnkmjankmbcc.crx;3;14;14;3;0;11
dbbkgilokaohnhheanpibgklmhmknhmm.crx;0;11;11;0;0;11
dbepggeogbaibhgnhhndojpepiihcmeb.crx;3;9;9;3;0;6
dbfipcjecamggjfabeaclacjoohfjhhn.crx;1;7;7;1;0;6
dbfmnekepjoapopniengjbcpnbljalfg.crx;6;20;20;6;0;14
dciflieigdmogpmamcgbigingaodhnil.crx;0;4;4;0;0;4
dcjichoefijpinlfnjghokpkojhlhkgl.crx;4;5;5;4;0;1
dcmcdoaknaojppeomaejlbjbpgocdhok.crx;5;12;13;4;1;8
dcngeagmmhegagicpcmpinaoklddcgon.crx;1;3;3;1;0;2
ddadgcdmddljmpkpinkalnepdepplpkj.crx;1;2;2;1;0;1
ddaloccgjfibfpkalenodgehlhkgoahe.crx;0;3;3;0;0;3
dddpdjidpiddnldfpabcelinhoknaphc.crx;5;12;13;4;1;8
ddfgmkcedkmbgppkneoedidgnhfmbloc.crx;1;4;4;1;0;3
deeboegbjcnfgidliakhpoapnpomphji.crx;3;13;13;3;0;10
defekohaofmambflfpfoojkmfdpcbgko.crx;0;1;1;0;0;1
dehajjkfchegiinhcmoclkfbnmpgcahj.crx;1;3;3;1;0;2
dgbldpiollgaehnlegmfhioconikkjjh.crx;1;11;11;1;0;10
dggphokdgjikekfiakjcpidcclbmkfga.crx;0;0;0;0;0;0
dgkhjjcoidmkfegigfdedmafpfemccpk.crx;4;11;11;4;0;7
dgkkmcknielgdhebimdnfahpipajcpjn.crx;0;0;0;0;0;0
dgldcllfgcheelimlbmilnkilnamlhbd.crx;1;6;6;1;0;5
dgmanlpmmkibanfdgjocnabmcaclkmod.crx;2;3;3;2;0;1
dhdgffkkebhmkfjojejmpbldmpobfkfo.crx;10;14;16;8;2;6
dhiaggccakkgdfcadnklkbljcgicpckn.crx;1;4;4;1;0;3
dhipmoghimfdldnocmopeoanjmoolofl.crx;0;2;2;0;0;2
dhmigidcmpihgdjpnjngdbleinendbon.crx;4;7;7;4;0;3
dionggdmdobjjolppiiejleechniphok.crx;0;2;2;0;0;2
djcfdncoelnlbldjfhinnjlhdjlikmph.crx;0;2;2;0;0;2
djdmadneanknadilpjiknlnanaolmbfk.crx;1;5;5;1;0;4
djflhoibgkdhkhhcedjiklpkjnoahfmg.crx;2;6;6;2;0;4
djhangopedggnlnicpbjklghlckmndge.crx;0;1;1;0;0;1
djhgiahomjkabjdodlemhnhbnbfcomam.crx;1;10;10;1;0;9
dkaagdgjmgdmbnecmcefdhjekcoceebi.crx;0;3;3;0;0;3
dkfhfaphfkopdgpbfkebjfcblcafcmpi.crx;3;7;7;3;0;4
dkgjopcolgcafhnicdahjemapkniikeh.crx;3;10;10;3;0;7
dknigoplijkheljacmlefjpbmdidhfag.crx;5;12;13;4;1;8
dlknooajieciikpedpldejhhijacnbda.crx;1;2;2;1;0;1
dlombpffcodogboaljnamhpphpdkjdam.crx;0;1;1;0;0;1
dmdidbedhnbabookbkpkgomahnocimke.crx;1;2;2;1;0;1
dmghijelimhndkbmpgbldicpogfkceaj.crx;1;3;3;1;0;2
dmgjckeibmdfndlflobjhddhmemajjld.crx;1;7;7;1;0;6
dmglolhoplikcoamfgjgammjbgchgjdd.crx;2;4;4;2;0;2
dmikeamgnillkjcolomlbfaaknanegig.crx;1;2;2;1;0;1
dmnddeddcgdllibmaodanoonljfdmooc.crx;3;4;4;3;0;1
dncepekefegjiljlfbihljgogephdhph.crx;0;3;3;0;0;3
dngbhajancmfmdnmhhdknhooljkddgnk.crx;0;3;3;0;0;3
dogkpdfcklifaemcdfbildhcofnopogp.crx;0;1;1;0;0;1
doknpakcpjkbnincdeoocojhnhndmhek.crx;1;2;2;1;0;1
dpdmhfocilnekecfjgimjdeckachfbec.crx;2;22;23;1;1;21
dpgjihldbpodlmnjolekemlfbcajnmod.crx;1;1;1;1;0;0
dphfngjamcomlehblpblaacingmaojnm.crx;0;1;1;0;0;1
dpioikmjnfipgphjldakcaocbbpnfabl.crx;0;0;0;0;0;0
dpjamkmjmigaoobjbekmfgabipmfilij.crx;0;0;0;0;0;0
dplabnbcafdgpcjmibgkekpaejlfhnkl.crx;0;4;4;0;0;4
dpplabbmogkhghncfbfdeeokoefdjegm.crx;0;4;4;0;0;4
eablhnhdlibgncddnfdcipphcblbkndd.crx;1;3;3;1;0;2
eadndfjplgieldjbigjakmdgkmoaaaoc.crx;0;2;2;0;0;2
eakacpaijcpapndcfffdgphdiccmpknp.crx;2;7;7;2;0;5
ebfkjhegjojpombijlnbkmjoabfgohkb.crx;0;6;6;0;0;6
ecgnghllmfapcigcdhadaackfjjhhifl.crx;5;12;13;4;1;8
ecmfchgfmbbddembehpkopmhjiepcckd.crx;5;10;10;5;0;5
ecnphlgnajanjnkcmbpancdjoidceilk.crx;4;12;12;4;0;8
ecpnacfdmkfdabpdpbnnacjfdfcldklf.crx;2;4;4;2;0;2
edacconmaakjimmfgnblocblbcdcpbko.crx;2;5;5;2;0;3
edlnojcclfhfnjegbdkcdigjnlmjkfnn.crx;0;3;3;0;0;3
ednpgmdbndmakimfpmcfgdlmhmhceehm.crx;4;7;7;4;0;3
edoadhjjfgeniilpmnoaddaihjkkhheb.crx;2;4;4;2;0;2
eeajicmampllnpkmfimkhefbndkfeloo.crx;1;7;7;1;0;6
eebnbmbhdfnfhfhigoklhaklkodghbla.crx;3;4;4;3;0;1
eecoahjklhopckkiefihjloeidikepdh.crx;0;1;1;0;0;1
eedlgdlajadkbbjoobobefphmfkcchfk.crx;0;6;6;0;0;6
eekailopagacbcdloonjhbiecobagjci.crx;2;4;4;2;0;2
eekbbmglbfldjpgbmajenafphnfjonnc.crx;1;1;1;1;0;0
eenflijjbchafephdplkdmeenekabdfb.crx;3;5;5;3;0;2
eeocglpgjdpaefaedpblffpeebgmgddk.crx;1;5;5;1;0;4
eeocknbjpmfgaclencnfjfkklmmfmiie.crx;3;9;9;3;0;6
eeojlpepoljdpaoiplnlhcfkoigijimc.crx;5;12;13;4;1;8
efaidnbmnnnibpcajpcglclefindmkaj.crx;3;5;6;2;1;3
efdhoaajjjgckpbkoglidkeendpkolai.crx;2;4;4;2;0;2
egfgboclmgbokjeenpnghneoaogefnjn.crx;0;0;0;0;0;0
eggkanocgddhmamlbiijnphhppkpkmkl.crx;2;7;7;2;0;5
egncdnniomonjgpjbapalkckojhkfddk.crx;2;4;4;2;0;2
ehajnnplicdlmalblkgpkhhbogkbmiee.crx;3;5;5;3;0;2
ehhkfhegcenpfoanmgfpfhnmdmflkbgk.crx;9;16;17;8;1;8
eiadekoaikejlgdbkbdfeijglgfdalml.crx;2;2;2;2;0;0
eignhdfgaldabilaaegmdfbajngjmoke.crx;0;8;8;0;0;8
eimadpbcbfnmbkopoojfekhnkhdbieeh.crx;0;4;4;0;0;4
ejbjamhkdedinncaeiackcdehpccoejm.crx;2;11;11;2;0;9
ejkiikneibegknkgimmihdpcbcedgmpo.crx;1;3;3;1;0;2
ekhagklcjbdpajgpjgmbionohlpdbjgc.crx;0;7;7;0;0;7
ekjblaihiicbgjibfipjoepkmondnnbd.crx;0;7;7;0;0;7
elgalmkoelokbchhkhacckoklkejnhcd.crx;1;1;1;1;0;0
elicpjhcidhpjomhibiffojpinpmmpil.crx;1;6;6;1;0;5
elioihkkcdgakfbahdoddophfngopipi.crx;1;5;5;1;0;4
eljapbgkmlngdpckoiiibecpemleclhh.crx;2;5;5;2;0;3
elmbellnejnajbokkjokedldcgnmiean.crx;1;3;3;1;0;2
elmekokodcohlommfikpmojheggnbelo.crx;1;4;4;1;0;3
emakkfldeggiinnfcdjkakdfcppbfhdg.crx;3;3;3;3;0;0
emalgedpdlghbkikiaeocoblajamonoh.crx;0;5;5;0;0;5
emeokgokialpjadjaoeiplmnkjoaegng.crx;0;3;3;0;0;3
emffkefkbkpkgpdeeooapgaicgmcbolj.crx;2;9;9;2;0;7
emidddocikgklceeeifefomdnbkldhng.crx;0;0;0;0;0;0
emikbbbebcdfohonlaifafnoanocnebl.crx;1;7;7;1;0;6
emngkmlligggbbiioginlkphcmffbncb.crx;5;11;12;4;1;7
emnphkkblegpebimobpbekeedfgemhof.crx;1;5;5;1;0;4
enakmcmeealkdoeindgoeogldodhdeda.crx;0;6;6;0;0;6
encaiiljifbdbjlphpgpiimidegddhic.crx;0;2;2;0;0;2
eneafchapmodjpgnblggaoikpeemnicg.crx;1;1;2;0;1;1
enfjpmhokbnpfoeepdoaadbabkojlpfc.crx;4;7;7;4;0;3
enfolipbjmnmleonhhebhalojdpcpdoo.crx;0;3;3;0;0;3
enlmiihbdlkpihokdgndjhahhkfmfcga.crx;0;9;9;0;0;9
enmofgaijnbjpblfljopnpdogpldapoc.crx;0;0;0;0;0;0
eobejphpabbjeehffmbiecckpkggpbai.crx;4;10;10;4;0;6
eofcbnmajmjmplflapaojjnihcjkigck.crx;2;6;6;2;0;4
eogeabecipmckmihpmkgjbghbffcebcf.crx;1;6;6;1;0;5
eopjamdnofihpioajgfdikhhbobonhbb.crx;0;1;1;0;0;1
epanfjkfahimkgomnigadpkobaefekcd.crx;2;9;9;2;0;7
epcnnfbjfcgphgdmggkamkmgojdagdnn.crx;4;7;7;4;0;3
epljggmdileomnkecfgpmcjodnikpdmm.crx;5;12;13;4;1;8
fadndhdgpmmaapbmfcknlfgcflmmmieb.crx;0;2;2;0;0;2
fafkcdhkdngbpidlbjkflljdgnkbcmbc.crx;0;0;0;0;0;0
fagakgcelolinfnkfgekcnedpaklfcok.crx;3;8;8;3;0;5
faminaibgiklngmfpfbhmokfmnglamcm.crx;1;2;2;1;0;1
fanogbnclpilemkifpjeglokomebpnef.crx;0;0;0;0;0;0
fbcgkphadgmbalmlklhbdagcicajenei.crx;1;3;3;1;0;2
fbcohnmimjicjdomonkcbcpbpnhggkip.crx;3;7;7;3;0;4
fbimffnjoeobhjhochngikepgfejjmgj.crx;3;3;3;3;0;0
fbingkbgnhkfpmffjiekekmedohpmfef.crx;0;6;6;0;0;6
fbmppankahdodchhioklnbcmohehhjoa.crx;1;2;2;1;0;1
fbpmaadfebbedknhmeeijeicldjlegee.crx;2;2;2;2;0;0
fcachklhcihfinmagjnlomehfdhndhep.crx;2;5;6;1;1;4
fckiflggbbklphamiahbdpphdkaloafl.crx;4;7;7;4;0;3
fdcgdnkidjaadafnichfpabhfomcebme.crx;0;12;12;0;0;12
fdfofellfkldcddminajkgcgocndgkip.crx;5;12;13;4;1;8
fdgfkebogiimcoedlicjlajpkdmockpc.crx;3;7;7;3;0;4
fdjamakpfbbddfjaooikfcpapjohcfmg.crx;7;11;12;6;1;5
fdkhngaioieemngifhcjghfankkmbpca.crx;5;12;13;4;1;8
fdpohaocaechififmbbbbbknoalclacl.crx;3;3;5;1;2;2
felcpnemckonbbmnoakbjgjkgokkbaeo.crx;1;4;4;1;0;3
felnfjenhdokeebbbbakdolpghmceefo.crx;1;2;2;1;0;1
ffbhefmlcoihbjcmibbfkocmnaiacinp.crx;2;3;3;2;0;1
ffdaeeijbbijklfcpahbghahojgfgebo.crx;0;9;9;0;0;9
ffhkkpnppgnfaobgihpdblnhmmbodake.crx;2;6;6;2;0;4
ffjkhaeogkeelkioellpgcebmekedpag.crx;0;5;5;0;0;5
ffmdedmghpoipeldijkdlcckdpempkdi.crx;1;4;4;1;0;3
fgddmllnllkalaagkghckoinaemmogpe.crx;4;13;13;4;0;9
fgikemaeelgbhjnhnnahcpkjpafaeion.crx;1;3;3;1;0;2
fgkeilefmpmbamgcejhjpiecahcbipip.crx;1;3;3;1;0;2
fhgenkpocbhhddlgkjnfghpjanffonno.crx;1;3;3;1;0;2
fhndealchbngfhdoncgcokameljahhog.crx;4;8;8;4;0;4
fhplmmllnpjjlncfjpbbpjadoeijkogc.crx;2;9;9;2;0;7
fippmoadkcplphjkinfbenngmaiehngd.crx;0;3;3;0;0;3
fjcldmjmjhkklehbacihaiopjklihlgg.crx;1;1;1;1;0;0
fjoaledfpmneenckfbpdfhkmimnjocfa.crx;3;8;8;3;0;5
fkepacicchenbjecpbpbclokcabebhah.crx;2;4;4;2;0;2
fkfcmeoepjhclglafbppmeidjjolcgid.crx;5;12;13;4;1;8
fldkdmkgnlbehfgeifjpjabmandnchpe.crx;0;2;2;0;0;2
fllaojicojecljbmefodhfapmkghcbnh.crx;0;0;0;0;0;0
flliilndjeohchalpbbcdekjklbdgfkk.crx;5;7;8;4;1;3
floipahigmmkfhkoapmnijnlnboniglg.crx;0;1;1;0;0;1
fmigejbpbkpaahgimefkeocnfjhkfjpa.crx;0;0;0;0;0;0
fmkadmapgofadopljbjfkapdkoienihi.crx;0;1;1;0;0;1
fnbdnhhicmebfgdgglcdacdapkcihcoh.crx;4;10;10;4;0;6
fngmhnnpilhplaeedifhccceomclgfbg.crx;3;8;8;3;0;5
foocpcikeakahdlplgpgfoilanoajijf.crx;0;3;3;0;0;3
fpcglidohpgnccfckgbgnflcbdmlcibj.crx;1;3;3;1;0;2
fpdnjdlbdmifoocedhkighhlbchbiikl.crx;3;7;7;3;0;4
fpeepicldbpmefboahpolegllmiglnai.crx;5;12;13;4;1;8
fpfgeeomkfdefkckijiabdbogjkdaecd.crx;1;6;6;1;0;5
fpkknkljclfencbdbgkenhalefipecmb.crx;2;5;5;2;0;3
fploionmjgeclbkemipmkogoaohcdbig.crx;1;3;3;1;0;2
gaonpiemcjiihedemhopdoefaohcjoch.crx;3;3;3;3;0;0
gbammbheopgpmaagmckhpjbfgdfkpadb.crx;0;1;1;0;0;1
gbiekjoijknlhijdjbaadobpkdhmoebb.crx;1;1;1;1;0;0
gbilbeoogenjmnabenfjfoockmpfnjoh.crx;1;3;3;1;0;2
gbmdgpbipfallnflgajpaliibnhdgobh.crx;0;2;2;0;0;2
gcalenpjmijncebpfijmoaglllgpjagf.crx;10;14;16;8;2;6
gcbommkclmclpchllfjekcdonpmejbdp.crx;0;7;7;0;0;7
gcknhkkoolaabfmlnjonogaaifnjlfnp.crx;5;10;10;5;0;5
gclhodkofgoighinmongpkpncdpalejb.crx;2;10;10;2;0;8
gdejljjjgegbbgoopclmcaabkjlbcmdm.crx;0;0;0;0;0;0
gdemdiacmdlenhafnaccidmjffjfgpfd.crx;0;0;0;0;0;0
gdkkmnngogaccacpomdhdiahljbjihoc.crx;0;0;0;0;0;0
gecgipfabdickgidpmbicneamekgbaej.crx;1;1;1;1;0;0
geddoclleiomckbhadiaipdggiiccfje.crx;3;4;4;3;0;1
geelfhphabnejjhdalkjhgipohgpdnoc.crx;1;6;6;1;0;5
gegdfeiahlfolhcfioipjlkombmgbakh.crx;0;1;1;0;0;1
genhcfhnhdibpbagebadphjbjidlgkka.crx;2;12;12;2;0;10
gfjopfpjmkcfgjpogepmdjmcnihfpokn.crx;3;10;10;3;0;7
ggckablhhmjagmokplgnbamljajnhanm.crx;0;0;0;0;0;0
ggdplhaiiohpkafnlhlfikiomnboacoi.crx;0;0;0;0;0;0
ggengpicfffofkhheeiljiianaaflafh.crx;0;3;3;0;0;3
ggfgijbpiheegefliciemofobhmofgce.crx;1;3;3;1;0;2
ggicleapjflmhconogkjddhdbjfhppnm.crx;1;3;3;1;0;2
ggjhpefgjjfobnfoldnjipclpcfbgbhl.crx;0;8;8;0;0;8
ghagedffjalchgcgdgfindabkpnmalel.crx;2;4;4;2;0;2
ghahcnmfjfckcedfajbhekgknjdplfcl.crx;4;11;11;4;0;7
ghfmhofojkkfdnlfefhkckbflohgiicn.crx;0;3;3;0;0;3
ghgabhipcejejjmhhchfonmamedcbeod.crx;4;6;6;4;0;2
ghnomdcacenbmilgjigehppbamfndblo.crx;1;2;2;1;0;1
gibknaohbjhpkhcmjkljmpbnhkeejppp.crx;0;0;0;0;0;0
gibkoahgjfhphbmeiphbcnhehbfdlcgo.crx;0;1;1;0;0;1
gifllahgdeogmfooohjdgbhlpnjbacab.crx;1;3;3;1;0;2
gighmmpiobklfepjocnamgkkbiglidom.crx;2;11;12;1;1;10
gjedkhmeelbomjafdlehdcomjhobcnbk.crx;0;1;1;0;0;1
gjieilkfnnjoihjjonajndjldjoagffm.crx;4;8;8;4;0;4
gjjpophepkbhejnglcmkdnncmaanojkf.crx;5;6;7;4;1;2
gjknjjomckknofjidppipffbpoekiipm.crx;0;9;9;0;0;9
gjmohbdbnfkkjolmdfbhhdfjgjclomkd.crx;0;0;0;0;0;0
gkbhpmdajdojnnhkfgffkofkjifglkan.crx;0;3;3;0;0;3
gkcfopbmpihfnphgamgibhkdhdgnplfp.crx;7;14;14;7;0;7
gkjnkapjmjfpipfcccnjbjcbgdnahpjp.crx;3;7;7;3;0;4
gkljgfmjocfalijkgoogmfffkhmkbgol.crx;2;4;4;2;0;2
gkojfkhlekighikafcpjkiklfbnlmeio.crx;6;9;9;6;0;3
glbahmkkmopnlibcoplgdeljampelhof.crx;2;12;12;2;0;10
glbpbnmbilhbphkdfondghkkbobfnpgj.crx;4;7;7;4;0;3
glcimepnljoholdmjchkloafkggfoijh.crx;3;7;8;2;1;5
glcipcfhmopcgidicgdociohdoicpdfc.crx;0;2;2;0;0;2
glgomjpomoahpeekneidkinhcfjnnhmb.crx;2;4;4;2;0;2
gljjiokipgajokbgfmoekcdmfceoijjh.crx;2;4;4;2;0;2
glnpjglilkicbckjpbgcfkogebgllemb.crx;2;8;8;2;0;6
gmbgaklkmjakoegficnlkhebmhkjfich.crx;5;6;6;5;0;1
gmbmikajjgmnabiglmofipeabaddhgne.crx;6;8;8;6;0;2
gmlllbghnfkpflemihljekbapjopfjik.crx;4;13;13;4;0;9
gmngpagflejjoblmmamaonmnkghjmebh.crx;3;3;4;2;1;1
gmpaiomihcebnclahoknbodeiaiohcdi.crx;0;1;1;0;0;1
gnamdgilanlgeeljfnckhboobddoahbl.crx;2;11;11;2;0;9
gngocbkfmikdgphklgmmehbjjlfgdemm.crx;6;25;25;6;0;19
gocklaboggjfkolaknpbhddbaopcepfp.crx;3;10;10;3;0;7
goficmpcgcnombioohjcgdhbaloknabb.crx;3;3;5;1;2;2
gojamcfopckidlocpkbelmpjcgmbgjcl.crx;1;5;5;1;0;4
gojbdfnpnhogfdgjbigejoaolejmgdhk.crx;0;8;8;0;0;8
gokgophibdidjjpildcdbfpmcahilaaf.crx;4;15;15;4;0;11
gomekmidlodglbbmalcneegieacbdmki.crx;3;8;8;3;0;5
gpdjojdkbbmdfjfahjcgigfpmkopogic.crx;0;7;7;0;0;7
gphhapmejobijbbhgpjhcjognlahblep.crx;4;4;5;3;1;1
gpmlkknmhomikheehibdnedjampadffh.crx;1;4;4;1;0;3
gppongmhjkpfnbhagpmjfkannfbllamg.crx;0;5;5;0;0;5
haebnnbpedcbhciplfhjjkbafijpncjl.crx;2;3;3;2;0;1
hafdlehgocfcodbgjnpecfajgkeejnaa.crx;4;4;5;3;1;1
hbafkdenjgpaoodddmcakcpnnnlmhccg.crx;0;0;0;0;0;0
hbapdpeemoojbophdfndmlgdhppljgmp.crx;3;3;4;2;1;1
hbdkkfheckcdppiaiabobmennhijkknn.crx;1;3;4;0;1;3
hbenocdlplcecoeinkofhglalflpnaej.crx;5;12;13;4;1;8
hbepadcdhpahlikldbochnhfleejiokp.crx;0;4;4;0;0;4
hbfdlfmcdfjnghnhnlccdlcfiofhpall.crx;0;0;0;0;0;0
hbgknjagaclofapkgkeapamhmglnbphi.crx;2;4;4;2;0;2
hcimhbfpiofdihhdnofbdlhjcmjopilp.crx;0;1;1;0;0;1
hcjdanpjacpeeppdjkppebobilhaglfo.crx;2;2;2;2;0;0
hclgegipaehbigmbhdpfapmjadbaldib.crx;0;2;2;0;0;2
hdbipekpdpggjaipompnomhccfemaljm.crx;6;15;15;6;0;9
hddnkoipeenegfoeaoibdmnaalmgkpip.crx;3;5;5;3;0;2
hdgenjhkjihnmigcommchefpajjhdmba.crx;1;2;2;1;0;1
hdgnienkeomlaeeojaibeicglpoaadnj.crx;4;2;4;2;2;0
hdhinadidafjejdhmfkjgnolgimiaplp.crx;0;5;5;0;0;5
hdhkemhaommecijlogcmoeaogjjpkihm.crx;5;12;13;4;1;8
hdkdmoacnkphoadmfidlhfdobieblphn.crx;0;20;20;0;0;20
hdokiejnpimakedhajhdlcegeplioahd.crx;7;9;12;4;3;5
hegbjcdehgihjohghnmdpebepnoalode.crx;3;9;9;3;0;6
hegneaniplmfjcmohoclabblbahcbjoe.crx;0;7;7;0;0;7
hehijbfgiekmjfkfjpbkbammjbdenadd.crx;6;12;14;4;2;8
heildphpnddilhkemkielfhnkaagiabh.crx;2;5;5;2;0;3
hejilffmihldhlfocnabcgndjjpgadfl.crx;0;3;3;0;0;3
hekhdfjankbhklfkjmnmnefcacndeoll.crx;0;0;0;0;0;0
henmfoppjjkcencpbjaigfahdjlgpegn.crx;1;5;5;1;0;4
hfapbcheiepjppjbnkphkmegjlipojba.crx;2;4;4;2;0;2
hfdhpmpfpcnbboppkkkblilhbloejijj.crx;5;9;9;5;0;4
hflefjhkfeiaignkclmphmokmmbhbhik.crx;2;7;7;2;0;5
hgimnogjllphhhkhlmebbmlgjoejdpjl.crx;0;0;0;0;0;0
hgjdbeiflalimgifllheflljdconlbig.crx;2;10;10;2;0;8
hglennijikhdiodhggelknephplffdnc.crx;2;5;5;2;0;3
hgmhmanijnjhaffoampdlllchpolkdnj.crx;2;4;4;2;0;2
hgngncnljacgakaiifjcgdnknaglfipo.crx;0;0;0;0;0;0
hhfkcobomkalfdlmkongnhnhahkmnaad.crx;1;8;8;1;0;7
hhinaapppaileiechjoiifaancjggfjm.crx;1;4;4;1;0;3
hhjnhpofkbonfdlgpgicdhddoagmipbi.crx;5;12;13;4;1;8
hhlhjgianpocpoppaiihmlpgcoehlhio.crx;4;8;8;4;0;4
hhojmcideegachlhfgfdhailpfhgknjm.crx;1;3;3;1;0;2
hiajdlfgbgnnjakkbnpdhmhfhklkbiol.crx;3;5;7;1;2;4
hihakjfhbmlmjdnnhegiciffjplmdhin.crx;0;0;0;0;0;0
hihlaoogegdjakmdbpbilijdghoggkim.crx;4;5;6;3;1;2
hijnjfkkfccbdcgbbcdidhgfgfhiapib.crx;0;11;11;0;0;11
hjkckbejikoponkecmopgfnjfjpfnlga.crx;0;0;0;0;0;0
hjngolefdpdnooamgdldlkjgmdcmcjnc.crx;3;7;7;3;0;4
hjnhcgkngeeahimbfhejeaiijecekhba.crx;2;4;4;2;0;2
hkeaafmlcginkhibjjdijabnpfobeibe.crx;5;12;13;4;1;8
hkhggnncdpfibdhinjiegagmopldibha.crx;1;12;12;1;0;11
hlhbmnfdcklajeaeikfinieljfegamko.crx;0;0;0;0;0;0
hljlcojjbmffoecdmhomhgfjhkllhknp.crx;2;9;9;2;0;7
hlmakjgnljgfmijdlncejflbkjahlepm.crx;0;2;2;0;0;2
hlngmmdolgbdnnimbmblfhhndibdipaf.crx;0;1;1;0;0;1
hlphpjodcfdblfmbbdjodbfmlonmidfh.crx;0;4;4;0;0;4
hmanipjnbjnhoicdnooapcnfonebefel.crx;0;3;3;0;0;3
hmdcmlfkchdmnmnmheododdhjedfccka.crx;1;2;2;1;0;1
hmdfjdmlicmgkkofgdjcndplcepgohgi.crx;5;12;13;4;1;8
hmffdimoneaieldiddcmajhbjijmnggi.crx;1;2;2;1;0;1
hmhgeddbohgjknpmjagkdomcpobmllji.crx;5;6;7;4;1;2
hmlcjjclebjnfohgmgikjfnbmfkigocc.crx;2;8;8;2;0;6
hnbmfljfohghaepamnfokgggaejlmfol.crx;2;9;9;2;0;7
hniladkejehjfchadikcbjmgjaogciic.crx;0;2;2;0;0;2
hnkcfpcejkafcihlgbojoidoihckciin.crx;3;4;4;3;0;1
hnlkiofnhhoahaiimdicppgemmmomijo.crx;2;4;4;2;0;2
hnmpcagpplmpfojmgmnngilcnanddlhb.crx;9;16;16;9;0;7
hoapmlpnmpaehilehggglehfdlnoegck.crx;6;10;10;6;0;4
hobchglfhhkljdjhmaphljlccenfdlga.crx;0;0;0;0;0;0
hoboppgpbgclpfnjfdidokiilachfcbb.crx;1;9;9;1;0;8
hoklmmgfnpapgjgcpechhaamimifchmp.crx;1;6;6;1;0;5
hompjdfbfmmmgflfjdlnkohcplmboaeo.crx;0;0;0;0;0;0
honeoiacmpjnbchlccbcbogafdfjgnim.crx;1;9;9;1;0;8
honjcnefekfnompampcpmcdadibmjhlk.crx;2;6;6;2;0;4
hpfbhhfadeldpgnhdgmeghelaocbcdni.crx;1;10;10;1;0;9
hphffohcfcaeoekbkfibilcmmoakhmfc.crx;5;8;8;5;0;3
hppkmolfkplaopacolakfekiejedjapl.crx;4;6;9;1;3;5
iabeihobmhlgpkcgjiloemdbofjbdcic.crx;1;3;3;1;0;2
iaigceaehdihlnolehbapjfbbfpnlngg.crx;1;7;7;1;0;6
iakddmmledeclcodpbgebfkhegaaddge.crx;0;2;2;0;0;2
ibkclpciafdglkjkcibmohobjkcfkaef.crx;0;2;2;0;0;2
iblenkmcolcdonmlfknbpbgjebabcoae.crx;1;3;3;1;0;2
iblijlcdoidgdpfknkckljiocdbnlagk.crx;1;4;4;1;0;3
icegcmhgphfkgglbljbkdegiaaihifce.crx;3;10;10;3;0;7
icncamkooinmbehmkeilcccmoljfkdhp.crx;1;2;2;1;0;1
icpgjfneehieebagbmdbhnlpiopdcmna.crx;1;2;2;1;0;1
icpklikeghomkemdellmmkoifgfbakio.crx;1;5;5;1;0;4
idfiabaafjemgcecklpgnebaebonghka.crx;0;2;2;0;0;2
idfnpgjblkahngbondojabhffkkdekbd.crx;1;3;3;1;0;2
idgpnmonknjnojddfkpgkljpfnnfcklj.crx;0;5;5;0;0;5
idhfcdbheobinplaamokffboaccidbal.crx;0;2;2;0;0;2
idkloemkmldbemijiamdiolojbffnjlh.crx;1;8;8;1;0;7
ieaebnkibonmpbhdaanjkmedikadnoje.crx;1;1;1;1;0;0
iebboopaeangfpceklajfohhbpkkfiaa.crx;0;2;2;0;0;2
ifajfiofeifbbhbionejdliodenmecna.crx;2;12;12;2;0;10
ifalmiidchkjjmkkbkoaibpmoeichmki.crx;0;8;8;0;0;8
ifbchccfedjkkhlnffjckaghjdpchhmo.crx;0;1;1;0;0;1
ifbhccdddhenjmeamogpjhicnoffdood.crx;0;0;0;0;0;0
ifbmcpbgkhlpfcodhjhdbllhiaomkdej.crx;0;2;2;0;0;2
iffdacemhfpnchinokehhnppllonacfj.crx;2;7;7;2;0;5
ifkgpacemihiplnocjocpgmoiefcojik.crx;1;1;1;1;0;0
ifmhoabcaeehkljcfclfiieohkohdgbb.crx;1;2;2;1;0;1
ifooldnmmcmlbdennkpdnlnbgbmfalko.crx;0;8;8;0;0;8
iggpfpnahkgpnindfkdncknoldgnccdg.crx;1;1;1;1;0;0
ighdmehidhipcmcojjgiloacoafjmpfk.crx;0;2;2;0;0;2
igiofjhpmpihnifddepnpngfjhkfenbp.crx;0;1;1;0;0;1
igloknlllonknnbkfgggfkigmeegmakf.crx;0;3;3;0;0;3
ihbiedpeaicgipncdnnkikeehnjiddck.crx;0;9;9;0;0;9
ihjbpjahiibmjdlcgodcnmpelpmilamk.crx;0;8;8;0;0;8
ihmgiclibbndffejedjimfjmfoabpcke.crx;1;8;8;1;0;7
ihpiinojhnfhpdmmacgmpoonphhimkaj.crx;4;7;7;4;0;3
iibninhmiggehlcdolcilmhacighjamp.crx;2;6;6;2;0;4
iifchhfnnmpdbibifmljnfjhpififfog.crx;0;1;1;0;0;1
iihkglbebihpaflfihhkfmpabjgdpnol.crx;3;9;9;3;0;6
iijhebjjpmafdakkpoipakjfkoimcgon.crx;0;6;6;0;0;6
iikalnbacgeabafoblilnnihbfgnbjfi.crx;1;3;3;1;0;2
iinglghmhcgdgjjlafobajghjamdchik.crx;2;8;8;2;0;6
ijhlikjoigjegofbedmfmlcfkmhabldh.crx;1;2;2;1;0;1
ijjnmdphpnlnelhbhefnfmimenjgbfcn.crx;5;12;13;4;1;8
ijkmjnaahlnmdjjlbhbjbhlnmadmmlgg.crx;3;2;3;2;1;0
ijmgkhchjindcjamnckoiahagecjnkdc.crx;2;2;2;2;0;0
ikgjglmlehllifdekcggaapkaplbdpje.crx;5;12;13;4;1;8
ikhdkkncnoglghljlkmcimlnlhkeamad.crx;3;9;9;3;0;6
ilagfnkoddifmfhjafpbhnikbhbeokom.crx;2;4;4;2;0;2
ilfoopambfaclfjmpiaijnccgcmbeigi.crx;0;2;2;0;0;2
imcbnnnoghiihopefblgehihofbfbmei.crx;3;6;6;3;0;3
imhlianhlhdicjchlbmbfaefhhjencbe.crx;0;0;0;0;0;0
imilbobhamcfahccagbncamhpnbkaenm.crx;1;3;3;1;0;2
immpkjjlgappgfkkfieppnmlhakdmaab.crx;1;4;4;1;0;3
inmmhkeajgflmokoaaoadgkhhmibjbpj.crx;0;1;1;0;0;1
innpjfdalfhpcoinfnehdnbkglpmogdi.crx;0;11;11;0;0;11
inobiceghmpkaklcknpniboilbjmlald.crx;0;4;4;0;0;4
inoeonmfapjbbkmdafoankkfajkcphgd.crx;3;8;8;3;0;5
ioalpmibngobedobkmbhgmadaphocjdn.crx;4;6;6;4;0;2
iobcbdgacfkninlcbphihhdlkobkehia.crx;1;2;2;1;0;1
iohcojnlgnfbmjfjfkbhahhmppcggdog.crx;3;7;7;3;0;4
iolcbmjhmpdheggkocibajddahbeiglb.crx;3;5;5;3;0;2
ipdjnhgkpapgippgcgkfcbpdpcgifncb.crx;2;8;8;2;0;6
ipkfnchcgalnafehpglfbommidgmalan.crx;0;1;1;0;0;1
ipkjmjaledkapilfdigkgfmpekpfnkih.crx;0;2;2;0;0;2
iplffkdpngmdjhlpjmppncnlhomiipha.crx;0;3;3;0;0;3
ipmkfpcnmccejididiaagpgchgjfajgp.crx;4;5;6;3;1;2
jabopobgcpjmedljpbcaablpmlmfcogm.crx;0;1;1;0;0;1
jacihiikpacjaggdldhcdfjpbibbfjmh.crx;5;9;9;5;0;4
jadhamcfimejpbemfkgoeijaimpciehj.crx;5;12;13;4;1;8
jaicfjhjlblbkhejmkfimkafjchdnafm.crx;1;7;7;1;0;6
jaogepninmlbinccpbiakcgiolijlllo.crx;4;6;6;4;0;2
jbabpmegbhgiadfbkmfocillkgfpfnjj.crx;1;5;5;1;0;4
jbbjocmjkcmpkocchmapgcnggkfifhno.crx;2;10;10;2;0;8
jbbplnpkjmmeebjpijfedlgcdilocofh.crx;1;4;4;1;0;3
jccfgghhbihbhomnlnadpjhkhmmboanj.crx;0;3;3;0;0;3
jcmgligingjhdnhdhgepemlckgcgmgaj.crx;0;0;0;0;0;0
jdbcdblgjdpmfninkoogcfpnkjmndgje.crx;1;1;1;1;0;0
jdcfmebflppkljibgpdlboifpcaalolg.crx;2;5;5;2;0;3
jdogphakondfdmcanpapfahkdomaicfa.crx;2;5;5;2;0;3
jdohjhblfhehfofehpagedgdkkdibned.crx;0;3;3;0;0;3
jdongfcbejkjibhkbekkjcckophhjcjj.crx;0;0;0;0;0;0
jeehnidbmlhpkncbplipfalpjkhlokaa.crx;2;5;5;2;0;3
jegbdfehmmeclcliadfdjbbpmhcjgclk.crx;2;5;5;2;0;3
jehfkemccjknagjgcbfccjajkgnbffpj.crx;1;3;3;1;0;2
jeoacafpbcihiomhlakheieifhpjdfeo.crx;3;11;11;3;0;8
jepibmfmhopgkplegmkjgifmhabbjadg.crx;4;8;8;4;0;4
jfbnmfgkohlfclfnplnlenbalpppohkm.crx;5;9;9;5;0;4
jfchnphgogjhineanplmfkofljiagjfb.crx;0;1;1;0;0;1
jfibpeiddefellcfgnijpcpddoimbdij.crx;1;9;9;1;0;8
jfiihjeimjpkpoaekpdpllpaeichkiod.crx;1;2;2;1;0;1
jfjnmganegfpajpgchndgfjbljnehink.crx;2;3;3;2;0;1
jfpdnkkdgghlpdgldicfgnnnkhdfhocg.crx;1;3;3;1;0;2
jgbbilmfbammlbbhmmgaagdkbkepnijn.crx;2;5;5;2;0;3
jgfbgkjjlonelmpenhpfeeljjlcgnkpe.crx;2;5;5;2;0;3
jgjhhoglgjdklldfgoffdiaceffijeke.crx;1;7;7;1;0;6
jgoepmocgafhnchmokaimcmlojpnlkhp.crx;0;1;1;0;0;1
jgpmhnmjbhgkhpbgelalfpplebgfjmbf.crx;1;2;2;1;0;1
jhcdlkgjiehgpnpolkbnmpffjodigbkb.crx;3;7;7;3;0;4
jicldjademmddamblmdllfneeaeeclik.crx;1;6;6;1;0;5
jicmnjcngcnfhgfggbdhlbjpcbadimaj.crx;7;11;11;7;0;4
jifbnihciifbfeiiijegkfnbigagacjk.crx;2;7;7;2;0;5
jimdfkeocobeeldobhpakapbhdeample.crx;0;1;1;0;0;1
jimekcmjahalpgniahhigkfichaihfkp.crx;5;12;13;4;1;8
jinjaccalgkegednnccohejagnlnfdag.crx;0;8;8;0;0;8
jiogeidobnphbnjmnlcjpopgfghcnebf.crx;1;3;3;1;0;2
jiomcgpfgkeefipihnplhadgdoollmap.crx;1;9;9;1;0;8
jipdnfibhldikgcjhfnomkfpcebammhp.crx;0;2;2;0;0;2
jjckigopagkhaikodedjnmbccfpnmiea.crx;5;9;9;5;0;4
jjfblogammkiefalfpafidabbnamoknm.crx;2;6;6;2;0;4
jjkofiknkjdjgkkbfdibgajealfbjhdj.crx;1;3;3;1;0;2
jjmflmamggggndanpgfnpelongoepncg.crx;2;3;3;2;0;1
jkbnhlhcdndaamafgbelomapajcnjpde.crx;5;12;13;4;1;8
jkfpchpiljkaemlpmpebnglgkomamfeo.crx;1;3;3;1;0;2
jkjmmpgbadnofhndilpigphmohdpmmnn.crx;1;5;5;1;0;4
jknkjnpcbbgcbdbaampbjlhkcghmgfhk.crx;2;3;3;2;0;1
jkompbllimaoekaogchhkmkdogpkhojg.crx;1;4;4;1;0;3
jkpbddholdmebbiaiplgihpkblipehim.crx;0;0;0;0;0;0
jldhpllghnbhlbpcmnajkpdmadaolakh.crx;2;4;4;2;0;2
jlhmfgmfgeifomenelglieieghnjghma.crx;0;4;4;0;0;4
jlkiooodjckigejdpbkbinlgooolgfhh.crx;1;4;4;1;0;3
jlleokkdhkflpmghiioglgmnminbekdi.crx;1;2;2;1;0;1
jlpafecglkplnaijkglfdmgilmnajeoc.crx;4;12;13;3;1;9
jmegndhbalhkegdidohofafobbcabine.crx;0;2;2;0;0;2
jmfdniemoeflbhlmcnammemhdahpcjni.crx;1;3;3;1;0;2
jmfikkaogpplgnfjmbjdpalkhclendgd.crx;0;2;2;0;0;2
jngdnjdobadbdemillgljnnbpomnfokn.crx;0;1;1;0;0;1
jngkenaoceimiimeokpdbmejeonaaami.crx;2;8;8;2;0;6
jnhgnonknehpejjnehehllkliplmbmhn.crx;3;6;7;2;1;4
jnihajbhpnppcggbcgedagnkighmdlei.crx;0;2;2;0;0;2
jninklaodadoeedinndhhlcflpmagfhd.crx;0;0;0;0;0;0
jnkdcmgmnegofdddphijckfagibepdlb.crx;3;10;10;3;0;7
jnkmfdileelhofjcijamephohjechhna.crx;1;3;3;1;0;2
jnnbmiailafajdkboegcjcdklooomfic.crx;5;12;13;4;1;8
jpaglkhbmbmhlnpnehlffkgaaapoicnk.crx;2;3;3;2;0;1
jpchabeoojaflbaajmjhfcfiknckabpo.crx;6;9;11;4;2;5
jpcmhcelnjdmblfmjabdeclccemkghjk.crx;1;1;1;1;0;0
jpfpebmajhhopeonhlcgidhclcccjcik.crx;5;12;12;5;0;7
jplnlifepflhkbkgonidnobkakhmpnmh.crx;5;8;8;5;0;3
kacljcbejojnapnmiifgckbafkojcncf.crx;7;10;10;7;0;3
kadalpbldokjhijcgndnldpheokmaeje.crx;3;9;10;2;1;7
kadbillinepbjlgenaliokdhejdmmlgp.crx;1;6;6;1;0;5
kaebhgioafceeldhgjmendlfhbfjefmo.crx;3;11;11;3;0;8
kaicbfmipfpfpjmlbpejaoaflfdnabnc.crx;2;5;5;2;0;3
kaimfhiiegblglllpkcpoegelgefonef.crx;0;1;1;0;0;1
kajibbejlbohfaggdiogboambcijhkke.crx;0;4;4;0;0;4
kamdefopmcpnkpomihddfnelophmppej.crx;0;8;8;0;0;8
kanbnempkjnhadplbfgdaagijdbdbjeb.crx;0;5;5;0;0;5
kbfnbcaeplbcioakkpcpgfkobkghlhen.crx;0;7;7;0;0;7
kbhfoiaobflocffnclkigpkeoagheimn.crx;1;2;2;1;0;1
kbmfpngjjgdllneeigpgjifpgocmfgmb.crx;0;7;7;0;0;7
kbohafcopfpigkjdimdcdgenlhkmhbnc.crx;6;11;11;6;0;5
kbpnbonnhilfdihhodnflcplajklibbc.crx;0;1;1;0;0;1
kcahibnffhnnjcedflmchmokndkjnhpg.crx;0;4;4;0;0;4
kcboafodfidhkjhhagekcbeepegnccha.crx;1;3;3;1;0;2
kcdcneeneoifbeenbbnjodcflhdbaggp.crx;3;7;8;2;1;5
kcehcblfpidimbihdfophhhdejckolgh.crx;1;8;8;1;0;7
kcnhkahnjcbndmmehfkdnkjomaanaooo.crx;1;3;3;1;0;2
kdadialhpiikehpdeejjeiikopddkjem.crx;1;6;6;1;0;5
kdfieneakcjfaiglcfcgkidlkmlijjnh.crx;3;4;4;3;0;1
keffjnnjjpeemgobbiemjhpdmbbkedmh.crx;5;11;11;5;0;6
kegmckcemknjidbonocipjkllmnanchh.crx;0;0;0;0;0;0
kegphgaihkjoophpabchkmpaknehfamb.crx;1;5;5;1;0;4
kejbdjndbnbjgmefkgdddjlbokphdefk.crx;5;7;8;4;1;3
kekahkplibinaibelipdcikofmedafmb.crx;1;3;3;1;0;2
kfdpgmeoacdoadgannnoajmnbodcfmbn.crx;4;8;8;4;0;4
kgdipifddaiedehdphnflapcinbndgmb.crx;5;12;13;4;1;8
kgejglhpjiefppelpmljglcjbhoiplfn.crx;2;13;13;2;0;11
kgifkabikplflflabkllnpidlbjjpgbp.crx;5;11;11;5;0;6
kgjfgplpablkjnlkjmjdecgdpfankdle.crx;0;3;3;0;0;3
khhckppjhonfmcpegdjdibmngahahhck.crx;4;24;24;4;0;20
khmlalkcjmglpgdkmkmmgjcajahkoigj.crx;3;5;5;3;0;2
khnpeclbnipcdacdkhejifenadikeghk.crx;3;4;4;3;0;1
khpcanbeojalbkpgpmjpdkjnkfcgfkhb.crx;1;1;1;1;0;0
kiodaajmphnkcajieajajinghpejdjai.crx;4;8;8;4;0;4
kjacjjdnoddnpbbcjilcajfhhbdhkpgk.crx;2;5;5;2;0;3
kjehgfjdlamgemlkljpklaiiamnbeemk.crx;5;12;13;4;1;8
kjomkjjpbjeennhagfmlahfnlgleecmn.crx;0;7;7;0;0;7
kkelicaakdanhinjdeammmilcgefonfh.crx;3;3;4;2;1;1
klbibkeccnjlkjkiokjodocebajanakg.crx;3;6;6;3;0;3
klejemegaoblahjdpcajmpcnjjmkmkkf.crx;1;1;1;1;0;0
kmbaalodpmjjhpobkgljnelbpblnikkp.crx;1;3;3;1;0;2
kmdldgcmokdpmacblnehppgkjphcbpnn.crx;1;4;4;1;0;3
kmffehbidlalibfeklaefnckpidbodff.crx;1;9;9;1;0;8
kmomimblkpkjeilfbkinoonalgiejlcl.crx;3;8;8;3;0;5
knmaplknmljolhemkdmfahdfgddflgcd.crx;1;3;3;1;0;2
kobdbljpnocpkpobfnaenbbpmebpokgc.crx;4;7;7;4;0;3
kohoehgoafblafjinhplmhcbphgaaobc.crx;5;12;13;4;1;8
koiaokdomkpjdgniimnkhgbilbjgpeak.crx;4;8;8;4;0;4
kojolejmgolbhakghocbgjemjgbmcjig.crx;0;2;2;0;0;2
kpbnombpnpcffllnianjibmpadjolanh.crx;6;9;9;6;0;3
kpdjmbiefanbdgnkcikhllpmjnnllbbc.crx;0;1;1;0;0;1
kpiecbcckbofpmkkkdibbllpinceiihk.crx;1;6;6;1;0;5
kpocjpoifmommoiiiamepombpeoaehfh.crx;5;12;13;4;1;8
laankejkbhbdhmipfmgcngdelahlfoji.crx;0;4;4;0;0;4
lajdkhdcndkniopfefocbgbkofflagpm.crx;1;3;3;1;0;2
lajondecmobodlejlcjllhojikagldgd.crx;1;4;4;1;0;3
lalfpjdbhpmnhfofkckdpkljeilmogfl.crx;4;8;8;4;0;4
lamecoaceiheggdhlnjnmciaonfdamlg.crx;5;12;13;4;1;8
laookkfknpbbblfpciffpaejjkokdgca.crx;0;4;4;0;0;4
lapoiohkeidniicbalnfmakkbnpejgbi.crx;0;1;1;0;0;1
lbapdklahcjljfincdglncfpdgfhckcf.crx;5;12;13;4;1;8
lbclmokcohjnkfgopmmcjeijpfheafia.crx;4;12;13;3;1;9
lblbnlfhhblmfconjalikamamlgoobbe.crx;3;9;9;3;0;6
lbofcampnkjmiomohpbaihdcbjhbfepf.crx;3;6;6;3;0;3
ldipcbpaocekfooobnbcddclnhejkcpn.crx;0;2;2;0;0;2
ldjkgaaoikpmhmkelcgkgacicjfbofhh.crx;2;3;3;2;0;1
ldmgbgaoglmaiblpnphffibpbfchjaeg.crx;2;5;5;2;0;3
ledkfmfckejkemlmpckiaoaldhldfmbe.crx;1;2;2;1;0;1
leneiifcmnfminekdbgbofkdddlkhcep.crx;0;1;1;0;0;1
lfafdlnjaliaghpjdajmlcnnblkgcefh.crx;3;7;8;2;1;5
lflnplggpolkcgknahacafilopgngelc.crx;0;1;1;0;0;1
lfmmeekapjbfjachdkgabdaoccfclpaa.crx;4;9;9;4;0;5
lfpjkncokllnfokkgpkobnkbkmelfefj.crx;1;2;2;1;0;1
lgblnfidahcdcjddiepkckcfdhpknnjh.crx;1;10;10;1;0;9
lgcaihcaldinjhbbkbjhfibpplmfkgik.crx;0;8;8;0;0;8
lghjfnfolmcikomdjmoiemllfnlmmoko.crx;0;6;6;0;0;6
lgomjifbpjfhpodjhihemafahhmegbek.crx;1;2;2;1;0;1
lhgkegeccnckoiliokondpaaalbhafoa.crx;0;3;3;0;0;3
lhhikcmleiiookknkemgafeddfpohhaa.crx;1;3;3;1;0;2
lhokmkldpbmkdonojblicoaajnnhjdpo.crx;2;12;12;2;0;10
libedajeiljdoodmokbppgapcfbignci.crx;2;3;3;2;0;1
licccgnfdlgmmmgaddmbcepikfadcmpe.crx;0;0;0;0;0;0
liecbddmkiiihnedobmlmillhodjkdmb.crx;6;9;10;5;1;4
lifbcibllhkdhoafpjfnlhfpfgnpldfl.crx;1;2;2;1;0;1
liiajppdkgnbpjbpehejidbfjicnfioh.crx;4;12;13;3;1;9
lijhjhlnfifgoabbihoobnfapogkcjgk.crx;1;3;3;1;0;2
ljfidlkcmdmmibngdfikhffffdmphjae.crx;0;2;2;0;0;2
ljfpjnehmoiabkefmnjegmpdddgcdnpo.crx;1;4;4;1;0;3
ljgpiikiibdligadiaifmdemkbkahfnf.crx;0;3;3;0;0;3
ljighgeflmhnpljodhpcifcojkpancpm.crx;5;8;8;5;0;3
ljipkdpcjbmhkdjjmbbaggebcednbbme.crx;0;1;1;0;0;1
ljjfmghebmjpaiejfancfliimcblfape.crx;0;8;8;0;0;8
lkadffjmnaiokkdncgdlecdegajoiemi.crx;0;1;1;0;0;1
lkdiimaiohgpacfbgedcipmgigppaofn.crx;1;8;8;1;0;7
lkmofgnohbedopheiphabfhfjgkhfcgf.crx;1;3;3;1;0;2
llaficoajjainaijghjlofdfmbjpebpa.crx;5;10;10;5;0;5
llelondjpcjljnjihdflhpclcpbiaiba.crx;1;2;2;1;0;1
llfiafkffigghkooapnbkjgdhnelhbie.crx;5;12;13;4;1;8
llgiblikeclfoebojkplbcmnicgcabhg.crx;0;2;2;0;0;2
lljhpdalfpihmdokpgmobnbeibbkignc.crx;1;2;2;1;0;1
lmhkpmbekcpmknklioeibfkpmmfibljd.crx;3;5;5;3;0;2
lmjnegcaeklhafolokijcfjliaokphfk.crx;0;13;13;0;0;13
lmnganadkecefnhncokdlaohlkneihio.crx;0;2;2;0;0;2
lmpemnebipihbcadlafaidjibohhfocn.crx;3;6;6;3;0;3
lnbopcabgddpanjmeabponnjngbmemml.crx;1;2;2;1;0;1
lngfncacljheahfpahadgipefkbagpdl.crx;1;3;3;1;0;2
lnkdbjbjpnpjeciipoaflmpcddinpjjp.crx;0;1;1;0;0;1
lnmengjdnfjbochkdkcjbbpildacancp.crx;1;2;2;1;0;1
lokadhdaghfjbmailhhenifjejpokche.crx;2;7;7;2;0;5
lpcaedmchfhocbbapmcbpinfpgnhiddi.crx;4;9;9;4;0;5
lpdfbkehegfmedglgemnhbnpmfmioggj.crx;0;1;1;0;0;1
lpeoghjfjibnhpmakobgiidkhcckdhod.crx;0;2;2;0;0;2
lppkddfmnlpjbojooindbmcokchjgbib.crx;0;2;2;0;0;2
machgpbhmagipfaeifccppmhnbpckfcd.crx;0;0;0;0;0;0
mallpejgeafdahhflmliiahjdpgbegpk.crx;5;12;13;4;1;8
mbaanpgkpkoamihninlcegnjclcpibde.crx;2;4;4;2;0;2
mbacbcfdfaapbcnlnbmciiaakomhkbkb.crx;7;12;13;6;1;6
mbckjcfnjmoiinpgddefodcighgikkgn.crx;2;6;6;2;0;4
mbigbapnjcgaffohmbkdlecaccepngjd.crx;2;5;5;2;0;3
mbniclmhobmnbdlbpiphghaielnnpgdp.crx;2;9;9;2;0;7
mcbpblocgmgfnpjjppndjkmgjaogfceg.crx;1;3;3;1;0;2
mciiogijehkdemklbdcbfkefimifhecn.crx;5;15;15;5;0;10
mclkkofklkfljcocdinagocijmpgbhab.crx;1;3;3;1;0;2
mcpmofnlkemfkhgngcdppgbhncoflmpe.crx;1;4;4;1;0;3
mdanidgdpmkimeiiojknlnekblgmpdll.crx;1;2;2;1;0;1
mdddabjhelpilpnpgondfmehhcplpiin.crx;5;5;7;3;2;2
mdecngheoggadedkphdheohlgeldgkcp.crx;1;4;4;1;0;3
mdepocdhogfjacchiigdpmgnnfbjgane.crx;2;5;5;2;0;3
mdnmhbnbebabimcjggckeoibchhckemm.crx;7;12;13;6;1;6
meajfmicibjppdgbjfkpdikfjcflabpk.crx;0;0;0;0;0;0
mefhakmgclhhfbdadeojlkbllmecialg.crx;0;1;1;0;0;1
megbklhjamjbcafknkgmokldgolkdfig.crx;1;13;14;0;1;13
meoeeoaohbmgbocpdpnjklmfmjjagkkf.crx;3;8;8;3;0;5
mfaachojeblopbjilgfoejfgchojdfbd.crx;5;12;13;4;1;8
mfedioikeigljhjfpghdejnogniddhna.crx;0;1;1;0;0;1
mfembjnmeainjncdflaoclcjadfhpoim.crx;2;3;4;1;1;2
mffifeinkgjdnhnamgabdknfkdnmkgmj.crx;3;9;9;3;0;6
mfhjonocnlnodflomblbjnjdpllkeljo.crx;2;3;3;2;0;1
mfidmkgnfgnkihnjeklbekckimkipmoe.crx;5;4;7;2;3;2
mflnemhkomgploogccdmcloekbloobgb.crx;0;0;0;0;0;0
mgapcljibnhkigclmbmdhgehflhljbdd.crx;0;2;2;0;0;2
mgdcgnnjenhecpdnhpnhpmgndjenmnnk.crx;5;12;13;4;1;8
mgijmajocgfcbeboacabfgobmjgjcoja.crx;1;2;2;1;0;1
mgmiemnjjchgkmgbeljfocdjjnpjnmcg.crx;2;6;6;2;0;4
mgpdmkkhjffhfkbpeigghejkngiaaike.crx;1;3;3;1;0;2
mhgnbemghokalfakmkhpnbneaoaigpnj.crx;2;8;8;2;0;6
mhkhmbddkmdggbhaaaodilponhnccicb.crx;2;2;3;1;1;1
mihcahmgecmbnbcchbopgniflfhgnkff.crx;2;4;4;2;0;2
mjbepbhonbojpoaenhckjocchgfiaofo.crx;9;14;16;7;2;7
mjnbclmflcpookeapghfhapeffmpodij.crx;4;7;7;4;0;3
mkelkmkgljeohnaeehnnkmdpocfmkmmf.crx;2;7;7;2;0;5
mkihbloiacgiofaejgagokalpeflnmbe.crx;1;5;5;1;0;4
mlefeoahnedalnibhngonildmfhjbcai.crx;0;0;0;0;0;0
mlikepnkghhlnkgeejmlkfeheihlehne.crx;1;2;2;1;0;1
mlnnopicjonfamklpcdfnbcomdlopmof.crx;0;3;3;0;0;3
mloajfnmjckfjbeeofcdaecbelnblden.crx;4;13;13;4;0;9
mlomiejdfkolichcflejclcbmpeaniij.crx;4;6;6;4;0;2
mmcblfncjaclajmegihojiekebofjcen.crx;2;2;3;1;1;1
mmgkbcihahpocjmclehpjejmgjmijcib.crx;5;12;13;4;1;8
mmpljmegdkddjkklnheaaldbcblcpjpb.crx;4;8;8;4;0;4
moiiphobnfkcebehgeongkfomgmcoaed.crx;5;12;13;4;1;8
molncoemjfmpgdkbdlbjmhlcgniigdnf.crx;0;6;6;0;0;6
mpgknomjjgfnghhmhnhgpmanpkccgkoc.crx;0;1;1;0;0;1
nafpfdcmppffipmhcpkbplhkoiekndck.crx;0;0;0;0;0;0
nagnmfhgkjkplbhplkbicmpkfopmnefp.crx;1;7;7;1;0;6
nbcojefnccbanplpoffopkoepjmhgdgh.crx;5;8;8;5;0;3
nbokbjkabcmbfdlbddjidfmibcpneigj.crx;1;1;1;1;0;0
ncbofnhmmfffmcdmbjfaigepkgmjnlne.crx;2;7;7;2;0;5
ncdfeghkpohnalmpblddmnppfooljekh.crx;4;5;6;3;1;2
ncennffkjdiamlpmcbajkmaiiiddgioo.crx;3;7;7;3;0;4
nckgahadagoaajjgafhacjanaoiihapd.crx;0;9;9;0;0;9
nddnemlpojcbnidlchlpofdpfmhgknah.crx;1;9;9;1;0;8
ndhinffkekpekljifjkkkkkhopnjodja.crx;0;1;1;0;0;1
ndjpnladcallmjemlbaebfadecfhkepb.crx;0;10;10;0;0;10
ndnaehgpjlnokgebbaldlmgkapkpjkkb.crx;4;9;9;4;0;5
neebplgakaahbhdphmkckjjcegoiijjo.crx;3;21;21;3;0;18
nemmanchfojaehgkbgcfmdiidbopakpp.crx;1;3;3;1;0;2
nenlahapcbofgnanklpelkaejcehkggg.crx;2;8;8;2;0;6
nfcilgimggemnogfigihdkmapdhhlbph.crx;0;0;0;0;0;0
nfdfiepdkbnoanddpianalelglmfooik.crx;1;5;5;1;0;4
nffaoalbilbmmfgbnbgppjihopabppdk.crx;1;2;2;1;0;1
nfoabicoimpcomnmnjpahiadjpinkklh.crx;2;4;4;2;0;2
nfphpgdlkoindbccbdmilopgeafllemo.crx;3;8;8;3;0;5
nglbhlefjhcjockellmeclkcijildjhi.crx;1;5;5;1;0;4
ngoecilmgkggmojcbhibnfjadhkpfjio.crx;3;7;7;3;0;4
nhahncknpppipmgjchbbhehkfglelepf.crx;0;2;2;0;0;2
nhdogjmejiglipccpnnnanhbledajbpd.crx;1;2;2;1;0;1
nibemhgacghipbplejpapmlnlkdaggbj.crx;1;7;7;1;0;6
nicokganngdkmjiejngaacdlllkdpikn.crx;1;5;5;1;0;4
niloccemoadcdkdjlinkgdfekeahmflj.crx;0;4;4;0;0;4
niojcggonafbneajjmkpkcigabaobmge.crx;5;12;13;4;1;8
njajpefejmjnhcddhaleakkcehiilppa.crx;1;5;5;1;0;4
njnmnphjljmejmfacphkagccdnajkghk.crx;4;12;13;3;1;9
nkbihfbeogaeaoehlefnkodbefgpgknn.crx;0;3;3;0;0;3
nkgmhpdhaaijoaeaokmhdpfegfmbmfjg.crx;1;8;8;1;0;7
nkihdmlheodkdfojglpcjjmioefjahjb.crx;1;3;3;1;0;2
nlbejmccbhkncgokjcmghpfloaajcffj.crx;0;11;11;0;0;11
nlbjncdgjeocebhnmkbbbdekmmmcbfjd.crx;1;2;2;1;0;1
nlbmnnijcnlegkjjpcfjclmcfggfefdm.crx;1;2;2;1;0;1
nlddiojjnkclocngpifciakljgljhdbo.crx;1;3;3;1;0;2
nlffgllnjjkheddehpolbanogdeaogbc.crx;0;0;0;0;0;0
nlhjgcligpbnjphflfdbmabbmjidnmek.crx;0;2;2;0;0;2
nlipoenfbbikpbjkfpfillcgkoblgpmj.crx;4;11;12;3;1;8
nlmbdmpjmlijibeockamioakdpmhjnpk.crx;0;4;4;0;0;4
nlmmgnhgdeffjkdckmikfpnddkbbfkkk.crx;3;5;5;3;0;2
nmdhbmdklokcmpmcegmbfehjencmbeab.crx;1;4;4;1;0;3
nmkinhboiljjkhaknpaeaicmdjhagpep.crx;1;1;1;1;0;0
nnajoiemfpldioamchanognpjmocgkbg.crx;0;4;4;0;0;4
nnckehldicaciogcbchegobnafnjkcne.crx;4;8;8;4;0;4
nngdfnnnkccipoglcgppagpgjkkbfclo.crx;0;3;3;0;0;3
nnjjahlikiabnchcpehcpkdeckfgnohf.crx;3;7;7;3;0;4
nnnmhgkokpalnmbeighfomegjfkklkle.crx;0;3;3;0;0;3
nnooggpliipegmffiolegeppbgkclbpi.crx;1;9;9;1;0;8
noaijdpnepcgjemiklgfkcfbkokogabh.crx;1;4;4;1;0;3
noojglkidnpfjbincgijbaiedldjfbhh.crx;0;2;2;0;0;2
noondiphcddnnabmjcihcjfbhfklnnep.crx;3;6;6;3;0;3
nopfnnpnopgmcnkjchnlpomggcdjfepo.crx;2;6;6;2;0;4
npecfdijgoblfcgagoijgmgejmcpnhof.crx;0;2;2;0;0;2
npeicpdbkakmehahjeeohfdhnlpdklia.crx;1;1;1;1;0;0
npgcnondjocldhldegnakemclmfkngch.crx;4;10;10;4;0;6
npmoikddpdgbhgbkjgjemncoegpojpng.crx;5;12;13;4;1;8
oaepeijninfcgjdnighjnlgdkkgpnaen.crx;1;3;3;1;0;2
oaobmlmjmhedmlphfdmdjpppjmcljnkp.crx;0;1;1;0;0;1
obnfifcganohemahpomajbhocfkdgmjb.crx;0;0;0;0;0;0
ocbnncepjggfkepliegikkfeahjibaoo.crx;4;5;6;3;1;2
ocggccaacacpienfcgmgcihoombokbbj.crx;5;15;15;5;0;10
ocpljaamllnldhepankaeljmeeeghnid.crx;1;16;16;1;0;15
odcommfbpjnempjflnjmgmnfpgcadboo.crx;5;12;13;4;1;8
odijcgafkhpobjlnfdgiacpdenpmbgme.crx;1;3;3;1;0;2
odnkdlljodaaoohicokdbbkplhemmkaf.crx;0;1;1;0;0;1
oefddkjnflmjbclpnnoegglmmdfkidip.crx;1;2;2;1;0;1
oejgccbfbmkkpaidnkphaiaecficdnfn.crx;1;9;9;1;0;8
oemmndcbldboiebfnladdacbdfmadadm.crx;3;7;7;3;0;4
oeopbcgkkoapgobdbedcemjljbihmemj.crx;2;12;12;2;0;10
ofcgiflmicieegobmapobiohjeokdbcd.crx;2;3;3;2;0;1
ofkelhbkifmecehjfolhkekgplfijkkf.crx;4;8;8;4;0;4
ofoeigeaodhbjogdigckajfhjbonaofg.crx;3;3;4;2;1;1
ogcgkffhplmphkaahpmffcafajaocjbd.crx;1;1;1;1;0;0
ogeebjpdeabhncjpfhgdibjajcajepgg.crx;0;5;5;0;0;5
ogfcmafjalglgifnmanfmnieipoejdcf.crx;7;10;11;6;1;4
oghkljobbhapacbahlneolfclkniiami.crx;7;10;13;4;3;6
ohahllgiabjaoigichmmfljhkcfikeof.crx;3;6;6;3;0;3
ohcpnigalekghcmgcdcenkpelffpdolg.crx;2;4;4;2;0;2
ohfjpkccecpdfkpmfocndhepolhljfhg.crx;1;4;4;1;0;3
ohjkicjidmohhfcjjlahfppkdblibkkb.crx;1;1;1;1;0;0
ohlencieiipommannpdfcmfdpjjmeolj.crx;0;2;2;0;0;2
ohlghnkgcadghcdodlcjfhogekonhdei.crx;0;1;1;0;0;1
ohodmcahedcphoipgooelhjcfahodhcj.crx;0;9;9;0;0;9
oiaejidbmkiecgbjeifoejpgmdaleoha.crx;1;7;7;1;0;6
oiecklaabeielolbliiddlbokpfnmhba.crx;2;5;5;2;0;3
oiekdmlabennjdpgimlcpmphdjphlcha.crx;1;7;7;1;0;6
oiiaigjnkhngdbnoookogelabohpglmd.crx;3;7;7;3;0;4
oiigbmnaadbkfbmpbfijlflahbdbdgdf.crx;5;8;8;5;0;3
oijdcdmnjjgnnhgljmhkjlablaejfeeb.crx;0;1;1;0;0;1
oingodpdjohhkelnginmkagmkbplgema.crx;1;2;2;1;0;1
ojbimichjpkfdgpoiedkbjlphjnjclli.crx;2;5;5;2;0;3
ojedkepkekklpjcgdfiahladdbopbooh.crx;1;8;8;1;0;7
ojhmphdkpgbibohbnpbfiefkgieacjmh.crx;1;3;3;1;0;2
ojkcdipcgfaekbeaelaapakgnjflfglf.crx;0;4;4;0;0;4
ojplelelocihfchkdaebocpankipadmp.crx;0;4;4;0;0;4
okadibdjfemgnhjiembecghcbfknbfhg.crx;1;1;1;1;0;0
okehlnjpihomkdokiiafpejniofjaoom.crx;0;0;0;0;0;0
oknpjjbmpnndlpmnhmekjpocelpnlfdi.crx;2;4;4;2;0;2
oldceeleldhonbafppcapldpdifcinji.crx;2;3;3;2;0;1
oliajjhpgpfciobcodfdhmgcbgmgkffe.crx;0;2;2;0;0;2
olkpikmlhoaojbbmmpejnimiglejmboe.crx;6;9;9;6;0;3
omdakjcmkglenbhjadbccaookpfjihpa.crx;5;8;8;5;0;3
omehpoiendopanbphjpldbacbjjleknj.crx;0;0;0;0;0;0
omghfjlpggmjjaagoclmmobgdodcjboh.crx;1;6;7;0;1;6
omioeahgfecgfpfldejlnideemfidnkc.crx;4;9;9;4;0;5
ompiailgknfdndiefoaoiligalphfdae.crx;0;6;6;0;0;6
oncckmaelaecccmaniihojgeopkcajfh.crx;1;2;2;1;0;1
onhbegdkgonhlokobjefolhpoidcnida.crx;3;5;5;3;0;2
onhiacboedfinnofagfgoaanfedhmfab.crx;4;11;11;4;0;7
onimolfnbjjikjiialpfahffkjjgdgkh.crx;5;8;8;5;0;3
onjjgbgnpbedmhbdoikhknhflbfkecjm.crx;0;8;8;0;0;8
ooadnieabchijkibjpeieeliohjidnjj.crx;0;2;2;0;0;2
oocalimimngaihdkbihfgmpkcpnmlaoa.crx;2;3;3;2;0;1
oofgbpoabipfcfjapgnbbjjaenockbdp.crx;5;8;8;5;0;3
oofnbdifeelbaidfgpikinijekkjcicg.crx;0;9;9;0;0;9
oopfofniljocdmhkdndkbojcollpflbb.crx;5;12;13;4;1;8
opgodjgjgojjkhlmmhdlojfehcemknnp.crx;1;1;1;1;0;0
ophjlpahpchlmihnnnihgmmeilfjmjjc.crx;6;9;9;6;0;3
ophjmddaoidnhjpfjiipefgmjcjfbgal.crx;4;12;13;3;1;9
opmibphegngmljhikklndacjdpkmhocp.crx;0;0;0;0;0;0
opnbmdkdflhjiclaoiiifmheknpccalb.crx;2;10;10;2;0;8
pachckjkecffpdphbpmfolblodfkgbhl.crx;1;4;4;1;0;3
padekgcemlokbadohgkifijomclgjgif.crx;5;8;8;5;0;3
paenbjlckelooppiepeiechkeehogoha.crx;1;8;8;1;0;7
pakcgdmajmmfhbcencogcblbflibaeln.crx;0;0;0;0;0;0
papbadoldddalgcjcicnikcfenodpghp.crx;0;1;1;0;0;1
pbcgcpeifkdjijdjambaakmhhpkfgoec.crx;0;5;5;0;0;5
pbcgnkmbeodkmiijjfnliicelkjfcldg.crx;1;7;7;1;0;6
pbdpajcdgknpendpmecafmopknefafha.crx;0;1;1;0;0;1
pbhelknnhilelbnhfpcjlcabhmfangik.crx;1;6;6;1;0;5
pbjikboenpfhbbejgkoklgkhjpfogcam.crx;0;9;9;0;0;9
pcahildbjonlnmkfcdeiglkeodeijdco.crx;1;6;6;1;0;5
pchfckkccldkbclgdepkaonamkignanh.crx;2;17;17;2;0;15
pdehbgibkbcbdhjjdnocmlficfilhlod.crx;1;2;2;1;0;1
pdheclofhikhpoeccofeaiceadiecace.crx;0;5;5;0;0;5
pdknmigbbbhmllnmgdfalmedcmcefdfn.crx;0;2;2;0;0;2
pdmdfkhjcfeafngnlommmdeemjcjfkbn.crx;0;0;0;0;0;0
pdnfnkhpgegpcingjbfihlkjeighnddk.crx;3;5;5;3;0;2
pegkceflonohbcefcbflfpficfkmpeod.crx;2;9;9;2;0;7
pehgadfgejpbgkgkofomjkbgfbnhdfll.crx;2;6;6;2;0;4
pekcnopmdcbjdgmpnpkndppflpldnkkp.crx;4;7;7;4;0;3
pemhgklkefakciniebenbfclihhmmfcd.crx;1;8;8;1;0;7
pfaogkfljpdfmodbmbogiiblppijleen.crx;0;0;0;0;0;0
pfgfgjlejbbpfmcfjhdmikihihddeeji.crx;0;2;2;0;0;2
pfjibkklgpfcfdlhijfglamdnkjnpdeg.crx;5;10;10;5;0;5
pflmllfnnabikmfkkaddkoolinlfninn.crx;0;2;2;0;0;2
pfmgfdlgomnbgkofeojodiodmgpgmkac.crx;2;4;4;2;0;2
pgbllmbdjgcalkoimdfcpknbjgnhjclg.crx;0;9;9;0;0;9
pgdnlhfefecpicbbihgmbmffkjpaplco.crx;0;0;0;0;0;0
pgeolalilifpodheeocdmbhehgnkkbak.crx;3;9;9;3;0;6
pgfbdgicjmhenccemcijooffohcdanic.crx;0;2;2;0;0;2
pgjikhlmdcngogboefkndfclclokdjem.crx;4;11;11;4;0;7
pgjjikdiikihdfpoppgaidccahalehjh.crx;2;4;4;2;0;2
pgphcomnlaojlmmcjmiddhdapjpbgeoc.crx;0;1;1;0;0;1
phgddhgfnjjaobkeekohieahfingldac.crx;0;3;3;0;0;3
phimhnckkaofkllcoledjilakgbeohli.crx;1;7;7;1;0;6
phkdcinmmljblpnkohlipaiodlonpinf.crx;1;3;3;1;0;2
phpaiffimemgakmakpcehgbophkbllkf.crx;3;7;7;3;0;4
pioclpoplcdbaefihamjohnefbikjilc.crx;2;6;6;2;0;4
pjiigpppomnbiofmlncldibopmghnklb.crx;0;0;0;0;0;0
pjnfggphgdjblhfjaphkjhfpiiekbbej.crx;0;1;1;0;0;1
pkehgijcmpdhfbdbbnkijodmdjhbjlgp.crx;2;8;8;2;0;6
pkfjcehoipcdbiilobhcblbkmelocaka.crx;2;12;12;2;0;10
pkgccpejnmalmdinmhkkfafefagiiiad.crx;4;6;7;3;1;3
pleaojdbmipmniiafnfmiainmdhkomgn.crx;3;8;8;3;0;5
plfknkdmhngcjepkalkhgpmhpolandfp.crx;5;8;9;4;1;4
plmndhfiofdlcgahoinehedbincopilm.crx;1;3;3;1;0;2
plpdjbappofmfbgdmhoaabefbobddchk.crx;2;1;2;1;1;0
pmhgccbbjcmlgoojajbkapfbbhbamkei.crx;1;3;3;1;0;2
pmnhcgfcafcnkbengdcanjablaabjplo.crx;0;0;0;0;0;0
pnacmlfckijnmogihjeaojfnfiplhhpj.crx;4;13;13;4;0;9
pnhflmgomffaphmnbcogleagmloijbkd.crx;0;9;9;0;0;9
pnhplgjpclknigjpccbcnmicgcieojbh.crx;8;8;12;4;4;4
pnjaodmkngahhkoihejjehlcdlnohgmp.crx;1;8;8;1;0;7
pnlccmojcmeohlpggmfnbbiapkmbliob.crx;0;10;10;0;0;10
pnnfemgpilpdaojpnkjdgfgbnnjojfik.crx;3;10;10;3;0;7
ponfpcnoihfmfllpaingbgckeeldkhle.crx;2;4;4;2;0;2
pooljnboifbodgifngpppfklhifechoe.crx;1;3;3;1;0;2
ppgadljdflpomdcdacknofppeejgmjdn.crx;3;5;5;3;0;2
ppgplhcfmaadpnkmnkhgadmaekeldbnh.crx;5;12;13;4;1;8
